1 2 3 1 2 3 1 2 3 1 2 3 1 2 3 1 2 3 1 2 3 1 2 3 1 0 0 1 2 3 1 3
2 0 0 0 0 0 0 0 0 0 0 0 6 6 6 6 6 7 7 7 6 6 7 6 6 6 6 6 7 0 0 2
3 0 4 4 5 5 4 4 5 5 0 0 7 6 6 7 7 7 7 7 6 6 7 6 6 6 6 6 0 0 0 1
1 0 0 0 0 0 0 0 0 0 0 0 0 6 6 6 6 7 7 7 6 6 7 6 6 6 6 6 0 0 0 3
2 0 5 5 5 5 5 0 0 0 0 0 0 0 0 0 0 0 0 0 4 4 4 4 4 4 4 4 0 0 0 2
3 0 0 0 0 0 0 0 0 0 5 5 5 5 5 0 0 0 0 4 4 4 4 4 4 4 4 0 0 0 0 1
1 0 0 0 0 0 0 0 0 0 0 0 0 0 0 0 0 0 0 4 4 4 4 4 4 4 4 0 0 0 0 3
2 4 4 4 4 4 4 0 0 0 0 0 0 0 0 0 0 0 0 0 4 4 4 4 4 4 4 4 0 0 0 2
3 4 4 4 5 4 4 4 0 0 0 0 0 0 0 0 0 0 0 0 0 0 0 0 0 0 0 0 0 0 0 1
1 4 4 5 5 4 4 4 4 0 0 0 0 0 0 0 0 0 0 0 0 0 0 0 0 0 0 0 0 0 0 3
2 0 4 4 5 4 4 4 4 4 4 4 4 4 0 0 0 0 0 0 5 5 5 5 5 0 0 0 0 0 0 2
3 0 0 0 0 0 0 5 0 5 5 5 5 5 0 0 0 0 0 0 0 0 0 0 0 0 0 0 0 0 0 1
1 0 0 0 0 0 5 5 5 5 5 5 5 4 0 0 0 0 0 0 0 0 0 0 0 0 0 0 0 0 0 3
2 0 0 0 0 0 0 5 0 0 4 4 5 5 0 0 0 0 0 0 5 5 5 5 5 0 0 0 0 0 0 2
3 0 0 0 5 5 5 5 5 0 0 0 0 0 0 0 0 0 4 4 4 4 4 4 0 0 0 0 0 0 0 1
1 0 0 0 5 5 5 5 5 0 0 0 0 0 0 0 0 0 0 4 4 4 4 4 4 0 0 0 0 0 0 3
2 0 0 0 5 5 5 5 5 0 0 0 0 0 0 0 0 0 0 0 4 4 4 4 4 0 0 0 0 0 0 2
3 0 0 0 0 0 0 0 0 0 5 6 6 6 6 6 6 0 0 0 4 4 4 4 4 0 0 0 0 0 0 1
1 0 0 0 0 0 0 0 0 0 0 6 6 6 6 6 0 0 0 0 4 4 4 4 4 0 0 0 0 0 0 3
2 0 0 0 0 0 0 0 0 0 0 6 7 7 7 6 0 0 0 0 4 4 4 4 4 0 0 0 0 0 0 2
3 6 6 6 6 6 0 0 0 0 0 6 7 7 7 6 0 0 0 0 4 4 4 4 4 0 0 0 0 0 0 1
1 6 6 6 6 6 7 7 7 7 7 6 6 6 6 6 0 0 0 0 4 4 4 4 4 0 0 0 0 0 0 3
2 6 7 7 6 6 7 7 7 7 7 6 6 6 6 6 0 0 0 0 4 4 4 4 4 4 0 0 0 0 0 2
3 6 6 6 6 6 7 6 6 6 7 6 6 6 6 6 0 0 0 4 4 4 4 4 4 0 0 0 0 0 0 1
1 2 3 1 2 3 1 2 3 1 2 3 1 2 3 1 2 3 1 2 3 1 2 3 1 2 3 1 2 3 1 3