1 2 3 1 2 3 1 2 3 1 2 3 1 2 3 1 2 3 1 2 3 1 2 3 1 2 3 1 2 3 1 3
2 6 6 6 6 6 6 6 6 6 6 6 6 6 6 6 6 6 6 6 6 6 6 6 6 6 6 6 6 6 6 1
3 6 6 6 6 6 6 6 6 6 6 6 6 6 6 6 6 6 6 6 6 6 6 6 6 6 6 6 6 6 6 2
1 6 6 6 6 6 6 7 7 6 6 6 6 6 6 6 6 6 6 7 6 6 6 6 6 6 6 6 6 6 6 3
2 6 6 6 6 6 7 7 7 7 6 6 6 6 6 6 6 6 6 7 6 6 6 6 6 6 6 6 6 6 6 1
3 6 6 6 6 6 7 7 7 7 7 6 6 6 6 6 6 6 6 7 6 6 6 6 6 6 6 6 6 6 6 2
1 6 6 6 6 7 7 7 7 7 7 7 6 6 6 6 6 6 7 7 6 6 6 6 6 6 6 6 6 6 6 3
2 6 6 6 7 7 7 7 7 7 7 7 7 6 6 6 6 6 7 7 6 6 6 6 6 6 6 6 6 6 6 1
3 6 6 6 6 7 7 7 7 7 7 7 7 7 7 6 7 7 7 7 7 6 6 6 6 6 6 6 6 6 6 2
1 6 6 6 6 7 7 7 7 7 7 7 7 7 7 7 7 7 7 7 7 7 7 6 6 6 6 6 6 6 6 3
2 6 6 6 6 6 7 6 7 7 7 7 7 6 6 6 7 7 7 7 7 7 7 7 6 6 6 6 6 6 6 1
3 6 6 6 6 6 7 7 7 7 6 6 6 6 6 6 6 7 7 7 7 6 6 6 6 6 6 6 6 6 6 2
1 6 6 6 6 6 7 6 6 6 6 6 6 6 6 6 6 6 7 7 6 6 6 6 6 6 6 6 6 6 6 3
2 6 6 6 6 6 6 6 6 6 6 6 6 6 6 6 6 6 6 6 6 6 6 6 6 6 6 6 6 6 6 1
3 6 6 6 6 6 6 6 6 6 6 6 6 6 6 6 6 6 6 6 6 6 6 6 6 6 6 6 6 6 6 2
12 12 12 12 12 12 12 12 12 12 12 12 12 12 12 12 12 12 12 12 12 12 12 12 12 12 12 6 6 6 6 3
12 12 12 12 12 12 12 12 12 12 12 12 12 12 12 12 12 12 12 12 12 12 12 12 12 12 12 6 6 6 6 1
3 6 6 6 6 6 6 6 6 6 6 6 6 6 6 6 6 6 6 6 6 6 6 6 6 12 12 6 6 6 6 2
1 6 6 6 6 6 6 6 6 6 6 6 6 6 6 6 6 6 6 6 6 6 6 6 6 12 12 6 6 6 6 3
2 6 4 6 6 6 6 6 6 6 6 6 6 6 6 6 6 6 6 6 6 6 6 6 6 12 12 6 6 6 6 1
3 6 4 6 6 6 6 6 6 6 6 6 6 6 6 6 6 6 6 6 6 6 6 6 6 12 12 6 6 6 6 2
1 6 4 6 4 6 4 4 6 6 6 4 6 6 6 6 6 6 6 6 6 6 6 6 6 12 12 6 6 6 6 3
2 4 4 4 4 4 4 4 4 4 4 4 6 6 6 6 6 6 6 4 4 4 4 4 4 12 12 4 4 4 4 1
3 6 4 6 6 4 4 4 4 6 6 4 6 6 4 4 4 4 4 4 4 4 4 4 4 12 12 4 4 4 4 2
1 2 3 1 2 3 1 2 3 1 2 3 1 2 3 1 2 3 1 2 3 1 2 3 1 12 12 1 2 3 1 3