1 2 3 1 2 3 1 2 3 1 2 3 1 2 3 1 2 3 1 2 3 1 2 3 1 2 3 1 2 3 1 3
2 17 17 17 17 17 17 17 17 17 17 0 6 6 6 6 6 7 7 7 6 6 7 6 6 6 6 6 7 0 0 2
3 17 17 17 17 5 4 4 5 17 17 0 7 6 6 7 7 7 7 7 6 6 7 6 6 6 6 6 0 0 0 1
1 17 17 17 0 0 0 0 0 0 0 0 0 6 6 6 6 7 7 7 6 6 7 6 6 6 6 6 0 0 0 3
2 17 17 5 5 5 5 0 0 0 0 0 0 0 0 0 0 0 0 0 4 4 4 4 4 4 4 4 0 0 0 2
3 17 17 0 0 0 0 0 0 0 5 5 5 5 5 0 0 0 0 4 4 4 4 4 4 4 4 0 0 0 0 1
1 17 17 0 0 0 0 0 0 0 0 0 0 0 0 0 0 0 0 4 4 4 4 4 4 4 4 0 0 0 0 3
2 17 17 17 12 12 12 12 12 12 12 12 12 12 12 12 12 12 0 0 4 4 4 4 4 4 4 4 0 0 0 2
3 17 17 17 17 12 12 12 12 12 12 12 12 12 12 12 12 12 0 0 0 0 0 0 0 0 0 0 0 0 0 1
1 17 17 17 17 17 4 4 4 0 0 0 0 0 0 0 12 12 0 0 0 0 0 0 0 0 0 0 0 0 0 3
2 17 17 17 17 17 17 4 4 4 4 4 4 4 0 0 12 12 0 0 5 5 5 5 5 0 0 0 0 0 0 2
3 17 17 17 17 17 17 5 0 5 5 5 5 5 0 0 12 12 0 0 0 0 0 0 0 0 0 0 0 0 0 1
1 17 17 17 17 17 17 17 5 5 5 5 5 4 0 0 12 12 0 0 0 0 0 0 0 0 0 0 0 0 0 3
2 17 17 17 17 17 17 17 0 0 4 4 5 5 0 0 12 12 0 0 5 5 5 5 5 0 0 0 0 0 0 2
3 17 17 17 17 17 17 17 5 0 0 0 0 0 0 0 12 12 4 4 4 4 4 4 0 0 0 0 0 0 0 1
1 17 17 17 17 17 17 17 5 0 0 0 0 0 12 12 12 12 12 12 12 12 12 12 12 12 12 12 12 12 12 12
2 17 17 17 17 17 17 17 17 0 0 0 0 0 12 12 12 12 12 12 12 12 12 12 12 12 12 12 12 12 12 12
3 17 17 17 17 17 17 17 17 17 5 6 6 6 6 6 6 0 0 0 4 4 4 4 4 0 0 0 0 0 0 1
1 17 17 17 17 17 17 17 17 17 0 6 6 6 6 6 0 0 0 0 4 4 4 4 4 0 0 0 0 0 0 3
2 17 17 17 17 17 17 17 17 17 0 6 7 7 7 6 0 0 0 0 4 4 4 4 4 0 0 0 0 0 0 2
3 17 17 17 17 17 17 17 17 17 0 6 7 7 7 6 0 0 0 0 4 4 4 4 4 0 0 0 0 0 0 1
1 17 17 17 17 17 17 17 17 17 7 6 6 6 6 6 0 0 0 0 4 4 4 4 4 0 0 0 0 0 0 3
2 17 17 17 17 17 17 17 17 17 7 6 6 6 6 6 0 0 0 0 4 4 4 4 4 4 0 0 0 0 0 2
3 17 17 17 17 17 17 17 17 17 7 6 6 6 6 6 0 0 0 4 4 4 4 4 4 0 0 0 0 0 0 1
1 2 3 1 2 3 1 2 3 1 2 3 1 2 3 1 2 3 1 2 3 1 2 3 1 2 3 1 2 3 1 3
