1 2 3 1 2 3 1 2 3 1 2 3 1 2 3 1 2 3 1 2 3 1 2 3 1 2 3 1 2 3 1 3
2 20 20 20 20 20 20 20 20 20 20 20 20 20 20 20 20 20 20 20 20 20 20 20 20 20 20 20 20 20 20 2
3 20 20 20 20 20 20 20 20 20 20 20 20 20 20 20 20 20 20 20 20 20 20 20 20 20 20 20 20 20 20 1
1 20 20 20 20 20 20 20 20 20 20 20 20 20 20 20 20 20 20 20 20 20 20 20 20 20 20 20 20 20 20 3
2 20 20 20 20 20 20 20 20 20 20 20 20 20 20 20 20 20 20 20 20 20 20 20 20 20 20 20 20 20 20 2
3 20 20 20 20 20 20 20 20 20 20 20 20 20 20 20 20 20 20 20 20 20 20 20 20 20 20 20 20 20 20 1
1 20 20 20 20 20 20 20 20 20 20 20 20 20 20 20 20 20 20 20 20 20 20 20 20 20 20 20 20 20 20 3
2 20 20 20 20 20 20 20 20 20 20 20 20 20 20 20 20 20 20 20 20 20 20 20 20 20 20 20 20 20 20 2
3 20 20 20 20 20 20 20 20 20 20 20 20 20 20 20 20 20 20 20 20 20 20 20 20 20 20 20 20 20 20 1
1 20 20 20 20 20 20 20 20 20 20 20 20 20 20 20 20 20 20 20 20 20 20 20 20 20 20 20 20 20 20 3
2 20 20 20 20 20 20 20 20 20 20 20 20 20 20 20 20 20 20 20 20 20 20 20 20 20 20 20 20 20 20 2
3 20 20 20 20 20 20 20 20 20 20 20 20 20 20 20 20 20 20 20 20 20 20 20 20 20 20 20 20 20 20 1
1 20 20 20 20 20 20 20 20 20 20 20 20 20 20 20 20 20 20 20 20 20 20 20 20 20 20 20 20 20 20 3
2 19 19 19 19 19 19 19 19 19 19 19 19 21 18 18 22 19 19 19 19 19 19 19 19 19 19 19 19 19 19 2
3 0 0 0 5 5 5 5 5 0 0 0 0 21 18 18 22 0 4 4 4 4 4 4 0 0 0 0 0 0 0 1
1 0 0 0 5 5 5 5 5 0 0 0 0 21 18 18 22 0 0 4 4 4 4 4 4 0 0 0 0 0 0 3
2 0 0 0 5 5 5 5 5 0 0 0 0 21 18 18 22 0 0 0 4 4 4 4 4 0 0 0 0 0 0 2
3 0 0 0 0 0 0 0 0 0 5 6 6 21 18 18 22 6 0 0 0 4 4 4 4 4 0 0 0 0 0 1
1 0 0 0 0 0 0 0 0 0 0 6 6 12 12 12 12 0 0 0 4 4 4 4 4 0 0 0 0 0 0 3
2 0 0 0 0 0 0 0 0 0 0 6 7 12 12 12 12 12 12 12 12 12 12 12 12 12 12 12 12 12 12 12
3 6 6 6 6 6 0 0 0 0 0 6 7 12 12 12 12 12 12 12 12 12 12 12 12 12 12 12 12 12 12 12
1 6 6 6 6 6 7 7 7 7 7 6 6 6 6 6 0 0 0 0 4 4 4 4 4 0 0 0 0 0 0 3
2 6 7 7 6 6 7 7 7 7 7 6 6 6 6 6 0 0 0 0 4 4 4 4 4 4 0 0 0 0 0 2
3 6 6 6 6 6 7 6 6 6 7 6 6 6 6 6 0 0 0 4 4 4 4 4 4 0 0 0 0 0 0 1
1 2 3 1 2 3 1 2 3 1 2 3 1 2 3 1 2 3 1 2 3 1 2 3 1 2 3 1 2 3 1 3